11111111111111111111111
10000100000000000000001
11100100111111111111001
10100000100000000000001
10111111100111111111111
10000000000000000000001
11111111111111111111101
10000000000000000000001
11111011111111111100001
10000100000000000100001
10111100100000000100001
10001000100000000000001
10001000111111111100001
10001000000000000010001
10001000000000000001111
10001111111111111000001
10000000000000000000001
11111111111111111100001
10000000000000000100001
10000000000000000100001
11111111111111111111111