111111111111111111111111
100000001000010000100001
111110000100100100100001
111101000010100100100001
100000100001000100000001
100000010000100100100001
100000001000000100100001
100000011111111100101111
100000100000000000100001
100001001001111111110001
100010000000000000000001
111111111111111111111111