111111111111111111111111
100000000000000000000001
111111111111010011111111
100000000001010010000001
100000000001010010000001
100000000001010010000001
100000000001010010000001
100000000001010010000001
100000000001010000000001
100000000001010010000001
100000000001010010000001
100000000001010010000001
100000000001010010000001
100000000001010010000001
100000000001010010000001
100000000001010111111111
100000000001010010000001
100000000001010010000001
100000000001010011111111
100000000001010000011011
100000000001010010011011
100000000001010010011011
100000000001010010000001
111111111111111111111111